1,5,5,5,5,5,5,5,5,3
1,5,5,5,5,5,5,5,5,3
1,5,5,5,5,5,5,5,5,3
1,5,5,5,5,5,5,5,5,3
4,0,0,0,5,5,5,5,5,3
1,5,5,5,5,5,0,0,0,4
1,5,5,5,5,5,5,5,5,3
4,0,0,0,5,5,5,5,5,3
1,5,5,5,5,5,0,0,0,4
1,5,5,5,5,5,5,5,5,3
4,0,0,0,5,5,5,5,5,3
1,5,5,5,5,5,0,0,0,4
1,5,5,5,5,5,5,5,5,3
1,5,5,5,5,5,5,5,5,3
4,0,0,0,0,0,0,0,0,4
4,4,4,4,4,4,4,4,4,4